2 1 10 15
.####..######..############..
.........#..........#.......#
#.#.###..#.#.#########.#.##.#
#.#.#.#####.#.#........#....#
#...#.#.....#.#.#####..###..#
##.#.###.#.#.#.#...#.#...#..#
#...#.#...#.#.#.#.#.#.#.#.#.#
###.#.#.#.#.#.#.#.#.#.#.#.#.#
#...#.#.#.#.#.#...#.#...#.#.#
###.#.#.#.#.#.#####.#.#.#.#.#
#...#.#.#.#...#.#...#.#...#.#
###.#.#.#.#####.#.#####.#.#.#
#...#...#.......#.......#.#.#
#.###############.#.#######.#
#.................#.........#
##########.##################